20/Pearl
 ██████████
█U         █
█ ████████ █
█ █      █ █
█ █      █ █
█ █      █ █
█ █      █ █
█ █      █ █
█ ████████ █
█         ░█
 ██████████