50/Hypnosis
 █████████
█U        █
████████  █
█   █░███ █
█ █ █   █ █
█ █  ██ █ █
█ █     █ █
█  █████  █
█         █
 █████████